0 0 0 0 0 0 0 0 0 0 0 0 0 0 0 0 0 0 0 0 0 0 0 0 0 0 0 0 0 0 0 0 0 0 0 0 0 0 0 0 0 0 0 0 0 0 0 0 0 0 0 0 0 0 0 0 0 0 0 0 0 0 0 0 0 0 0 0 0 0 0 0 0 0 0 0 0 0 0 0 0 0 0 0 0 0 0 0 0 0 0 0 0 0 0 0 
0 0 0 0 0 0 0 0 0 0 0 0 0 0 0 0 0 0 0 0 0 0 0 0 0 0 0 0 0 0 0 0 0 0 0 0 0 0 0 0 0 0 0 0 0 0 0 0 0 0 0 0 0 0 0 0 0 0 0 0 0 0 0 0 0 0 0 0 0 0 0 0 0 0 0 0 0 0 0 0 0 0 0 0 0 0 0 0 0 0 0 0 0 0 0 0 
1 1 1 1 1 2 3 1 1 2 3 1 1 2 3 1 1 2 3 1 1 2 3 1 1 1 1 1 1 1 1 1 1 1 1 1 1 2 3 1 1 2 3 1 1 2 3 1 1 2 3 1 1 2 3 1 1 1 1 1 1 1 1 1 1 1 1 1 1 1 1 1 1 1 1 1 1 1 1 1 1 1 4 5 0 4 0 5 0 4 0 5 5 6 0 0 
7 7 7 7 8 9 10 11 8 9 10 11 8 9 10 11 8 9 10 11 8 9 10 11 7 7 7 7 7 7 7 7 7 7 7 7 8 9 10 11 8 9 10 11 8 9 10 11 8 9 10 11 8 9 10 11 7 7 7 7 7 7 7 7 7 7 7 7 7 7 7 7 7 7 7 7 7 7 7 7 7 12 13 14 15 16 15 17 15 16 15 17 18 19 0 0 
8 20 20 20 21 22 22 10 21 22 22 10 21 22 22 10 21 22 22 10 21 22 22 10 7 7 7 7 7 7 7 7 8 20 20 20 21 22 22 10 21 22 22 10 21 22 22 10 21 22 22 10 21 22 22 10 7 7 7 7 7 7 7 7 7 7 7 7 7 7 7 7 7 7 7 7 7 7 7 7 12 0 23 0 24 25 25 25 24 25 25 25 26 27 0 0 
9 28 29 30 9 28 29 30 9 28 29 30 9 28 29 30 9 28 29 30 9 28 29 30 7 7 7 7 7 7 7 7 9 28 29 30 9 28 29 30 9 28 29 30 9 28 29 30 9 28 29 30 9 28 29 30 7 7 7 7 7 7 7 7 7 7 7 7 7 7 7 7 7 7 7 7 7 7 7 7 0 0 0 0 13 14 18 18 13 14 18 18 31 32 0 0 
22 33 34 9 22 33 34 9 22 33 34 9 22 33 34 9 22 33 34 9 22 33 34 9 7 8 11 7 7 8 11 7 22 33 34 9 22 33 34 9 22 33 34 9 22 33 34 9 22 33 34 9 22 33 34 9 7 8 11 7 7 8 11 7 7 8 11 7 7 8 11 7 7 8 11 7 7 8 11 7 0 0 0 0 13 35 18 18 13 35 18 18 36 34 0 0 
22 9 22 22 22 9 22 22 22 9 22 22 22 9 22 22 22 9 22 22 22 9 22 22 8 9 10 11 8 9 10 11 22 9 22 22 22 9 22 22 22 9 22 22 22 9 22 22 22 9 22 22 22 9 22 22 8 9 10 11 8 9 10 11 8 9 10 11 8 9 10 11 8 9 10 11 8 9 10 11 0 0 15 15 13 37 18 18 13 37 18 18 38 22 0 0 
30 22 22 22 22 29 22 22 30 22 22 22 30 22 22 22 30 22 22 22 30 22 22 22 21 22 22 10 21 22 22 10 30 22 22 22 22 29 22 22 30 22 22 22 30 22 22 22 30 22 22 22 30 22 22 22 21 22 22 10 21 22 22 10 21 22 22 10 21 22 22 10 9 29 22 10 9 29 22 10 0 0 24 25 39 40 41 42 13 18 18 18 43 44 0 0 
9 28 29 30 45 34 22 46 9 28 29 30 9 28 29 30 9 28 29 30 9 28 29 30 9 28 29 30 9 28 29 30 9 28 29 30 45 34 22 46 9 28 29 30 9 28 29 30 9 28 29 30 9 28 29 30 9 28 29 30 9 28 29 30 9 28 29 30 9 28 29 30 45 34 22 46 45 34 22 46 0 0 13 14 18 47 48 49 13 14 18 18 18 50 0 0 
22 33 34 9 51 45 46 52 22 33 34 9 22 33 34 9 22 33 34 9 22 33 34 9 22 33 34 9 22 33 34 9 22 33 34 9 51 45 46 52 22 33 34 9 22 33 34 9 22 33 34 9 22 33 34 9 22 33 34 9 22 33 34 9 22 33 34 9 22 33 34 9 51 45 46 52 51 45 46 52 0 0 13 5 18 19 0 0 13 35 18 18 18 50 0 0 
22 9 22 22 0 53 52 0 22 9 22 22 22 9 22 22 22 9 22 22 22 9 22 22 22 9 22 22 22 9 22 22 22 9 22 22 0 53 52 0 22 9 22 22 22 9 22 22 22 9 22 22 22 9 22 22 22 9 22 22 22 9 22 22 22 9 22 22 22 9 22 22 0 53 52 0 0 53 52 0 0 0 13 18 18 54 0 0 13 37 18 18 18 19 0 0 
22 29 22 22 0 55 0 0 22 29 22 22 22 29 22 22 22 29 22 22 22 29 22 22 22 29 22 22 22 29 22 22 22 29 22 22 0 55 0 0 22 29 22 22 22 29 22 22 22 29 22 22 22 29 22 22 22 29 22 22 22 29 22 22 22 29 22 22 22 29 22 22 0 55 0 0 0 55 0 0 0 0 13 18 18 50 0 0 13 18 18 18 26 27 0 0 
45 34 22 46 0 0 0 0 45 34 22 46 45 34 22 46 45 34 22 46 45 34 22 46 45 34 22 46 45 34 22 46 45 34 22 46 0 0 0 0 45 34 22 46 45 34 22 46 45 34 22 46 45 34 22 46 45 34 22 46 45 34 22 46 45 34 22 46 45 34 22 46 0 0 0 0 0 0 0 0 0 0 13 14 18 50 0 0 13 14 18 18 31 32 0 0 
51 45 46 52 0 56 57 0 51 45 46 52 51 45 46 52 51 45 46 52 51 45 46 52 51 45 46 52 51 45 46 52 51 45 46 52 0 56 57 0 51 45 46 52 51 45 46 52 51 45 46 52 51 45 46 52 51 45 46 52 51 45 46 52 51 45 46 52 51 45 46 52 0 56 57 0 0 0 0 0 0 0 13 5 18 50 0 0 13 35 18 18 36 34 0 0 
0 53 52 0 0 58 59 0 0 53 52 0 0 53 52 0 0 53 52 0 0 53 52 0 0 53 52 0 0 53 52 0 0 53 52 0 0 58 59 0 0 53 52 0 0 53 52 0 0 53 52 0 0 53 52 0 0 53 52 0 0 53 52 0 0 53 52 0 0 53 52 0 0 58 59 0 0 0 0 0 0 0 13 18 18 19 0 0 13 37 18 18 38 22 0 0 
0 55 60 0 0 61 62 0 0 55 0 0 0 55 60 0 0 55 60 0 0 55 0 0 0 55 60 0 0 55 0 0 0 55 60 0 0 61 62 0 0 55 0 0 0 55 60 0 0 55 60 0 0 55 0 0 0 55 60 0 0 55 0 0 0 55 0 0 0 55 0 0 0 61 62 0 0 0 0 0 0 0 13 18 63 64 0 0 13 18 26 65 38 66 0 0 
67 0 68 0 0 69 70 0 0 0 0 0 67 0 68 0 67 0 68 0 0 0 0 0 67 0 68 0 0 0 0 0 67 0 68 0 0 69 70 0 0 0 0 0 67 0 68 0 67 0 68 0 0 0 0 0 67 0 68 0 0 0 0 0 0 0 0 0 0 0 0 0 0 69 70 0 0 0 0 0 0 0 13 18 71 72 0 0 13 18 38 73 31 32 0 0 
74 75 76 60 77 78 79 80 81 81 81 81 74 75 76 60 74 75 76 60 81 81 81 81 74 75 76 60 81 81 81 81 74 75 76 60 77 78 79 80 81 81 81 81 74 75 76 60 74 75 76 60 81 81 81 81 74 75 76 60 81 81 81 81 81 81 81 81 0 82 83 77 77 78 79 80 80 84 0 85 85 86 87 88 89 90 0 0 91 92 93 93 36 34 0 0 
94 95 96 97 98 98 98 99 100 100 100 100 94 95 96 97 94 95 96 97 100 100 100 100 94 95 96 97 100 100 100 100 94 95 96 97 98 98 98 99 100 100 100 100 94 95 96 97 94 95 96 97 100 100 100 100 94 95 96 97 100 100 100 100 100 100 100 100 85 101 102 98 98 98 98 99 99 103 85 34 34 104 105 106 106 107 0 0 106 107 108 22 38 22 0 0 
109 109 109 109 109 109 109 109 109 109 109 109 109 109 109 109 109 109 109 109 109 109 109 109 109 109 109 109 109 109 109 109 109 109 109 109 109 109 109 109 109 109 109 109 109 109 109 109 109 109 109 109 109 109 109 109 109 109 109 109 109 109 109 109 109 109 109 109 109 109 109 109 109 109 109 109 109 109 109 109 109 109 109 109 109 109 109 109 109 109 109 109 109 109 109 109 
110 110 110 110 110 110 110 110 110 110 110 110 110 110 110 110 110 110 110 110 110 110 110 110 110 110 110 110 110 110 110 110 110 110 110 110 110 110 110 110 110 110 110 110 110 110 110 110 110 110 110 110 110 110 110 110 110 110 110 110 110 110 110 110 110 110 110 110 110 110 110 110 110 110 110 110 110 110 110 110 110 110 110 110 110 110 110 110 110 110 110 110 110 110 110 110 
0 0 0 0 0 0 0 0 0 0 0 0 0 0 0 0 0 0 0 0 0 0 0 0 0 0 0 0 0 0 0 0 0 0 0 0 0 0 0 0 0 0 0 0 0 0 0 0 0 0 0 0 0 0 0 0 0 0 0 0 0 0 0 0 0 0 0 0 0 0 0 0 0 0 0 0 0 0 0 0 0 0 0 0 0 0 0 0 0 0 0 0 0 0 0 0 
0 0 0 0 0 0 0 0 0 0 0 0 0 0 0 0 0 0 0 0 0 0 0 0 0 0 0 0 0 0 0 0 0 0 0 0 0 0 0 0 0 0 0 0 0 0 0 0 0 0 0 0 0 0 0 0 0 0 0 0 0 0 0 0 0 0 0 0 0 0 0 0 0 0 0 0 0 0 0 0 0 0 0 0 0 0 0 0 0 0 0 0 0 0 0 0 